111111111111111111
1E000000000P000C01
101001010010000011
101001001010101001
100000000C00C00001
111111111111111111
