1111111
10C00E1
1010011
1010011
1100P01
1111111
