111111111111111111
1E000000000P000C01
101001010010010011
101001001010100111
100000000C00C01111
111111111111111111
