1111111111111111111
1E0000C000000000P01
1010010100100000001
1000000000000000001
1000000000000000001
1000000000000000001
1111111111111111111
