1111111111111111111111111111111111
10000C000000C00C00000C000000000001
1010010100100000101001000000010108
1010010010101010001C010000C0010101
100000000C00C00E0000P00000000000C1
1111111111111111111111111111111111
