1111111
1E0C001
1E0CP01
1E0C001
1E0C001
1E0C001
1E0C001
1111111
