1111111111111111111
1E0000000000000C001
1010010100100000001
1010010010101010001
100000000C00C0000P1
1111111111111111111
