1111111111111111111111111111111111
1E0000000000000C00000C000000000001
1010010100100000101001000000101011
1010010101010100010010000000010101
10000P000C00C000000000000000000C11
1111111111111111111111111111111111
